#Map file for tile-based game
#(Lines that start with '#' are comments)
#The tiles are:
#	'~' = ScreenStarter
#	'G' = Ground
#	'O' = Long Pipe
#	'o' = Sideways Pipe
#	'S' = Blue Brick
#	'C' = Coins
#	'q' = Blue Coin Block
~
.
SS   SSSSSSSSSSSSSSSSSSO SSSSSSSSSSSS
SS   SSSSSSSSSSSSSSSSSS  SSSSSSSSSSSS
SS   SSSSSSSSSSSSSSSSSS  SSSSSSSSSSSS
SS   SSSSSSSSSSSSSSSSSS  SSSSSSSSSSSS
SS   SSSSSSSSSSSSSSSSSS  SSSSSSSSSSSS
SS                  SSS  SSSSSSSSSSSS
SS                  SSS  SSSSSSSSSSSS
SS                  SSS  SSSSSSSSSSSS
SS    C C C C C C C SSS  SSSSSSSSSSSS
SS   SSSSSSSSSSSSSSqSSS  SSSSSSSSSSSS
SS                   o   SSSSSSSSSSSS
SS    C C C C C C C      SSSSSSSSSSSS
GGGGGGGGGGGGGGGGGGGGGGGGGGGGGGGGGGGGG
GGGGGGGGGGGGGGGGGGGGGGGGGGGGGGGGGGGGG